###################
###.............###
#.................#
#.................#
#...###########...#
#.................#
#.................#
#.................#
#.................#
###.............###
###################