###################
#.......###.......#
#..###.......###..#
#.......###.......#
#..###.......###..#
#.................#
#..###.......###..#
#.......###.......#
#..###.......###..#
#.......###.......#
###################