###################
...................
...................
....###########....
...................
...................
...................
....###########....
...................
...................
###################