...................
...................
#############......
...................
......#############
...................
#############......
...................
......#############
...................
#############......