###################
...................
############...####
...................
####...############
...................
############...####
...................
####...############
...................
###################